2 W G I   2 2 W G W G G W W 1 I 2 1 W G 1 G 1 W W W 1 2 G W G I I G G I I W G G I G W 1 G I 1 W W W I W W W G 1 G W W W W 1 W 2 G I I I I W 1 W I W I I G G I 2 W W I G W W 2 I W W W W I W I G 2 I I G G G 2 G G W W G
G I G W 1 W W 2 W W W G W W I I I W 2 2 G I I I I 1 I I 1 W W W 2 W I I W W W 1 W G 1 G I 1 2 W W 2 I 2 G W G G G 2 W 2 W G G I G I W G W 1 2 W W G W G G W G G G W W 2 G I I 2 G W W I 2 2 G G I G G G W W G G G W I I
W I W G 1 W W I W W I W W W I W 1 W 2 W G 2 I I I I W W I G W W G G G I G W W G I W G I W W G G I W G W W G W W W 2 W G W W G W I W G 1 G W G I 2 G W W I I W W W G G G G W W W I W I 1 W G W G I G W W I W W W G W W W I
2 I W W W 2 G W W I W I G W W W G W I W W W I G G I G G W G W G W 1 G W W W 2 I 1 G W I W W W W G W G I G W W W 2 W W G W 2 I G G I I W W W W W I 2 G W W I G W W W W I I I W G W W G G W 2 G G G G I G W G I 2 W I G I I
G I I 1 I G W I W W W I I G G G 1 W I W G W I W G G W W G W 1 W I 2 I W W I W 1 I I W W W G I G G I G G G W I G W 2 W I 2 I G G W I W W G W I 2 G G W I W W 2 G G W I I G I W W W 2 I G W G W I 2 1 W W W I I W W G W 2 G
W G 2 W W G G I W G W W I W G W 1 W I I W G I I W G I W W I G W G W G G W G 1 W W W I W G 2 I W G G W W I I W W W G I 1 G 1 G W I W G W G W G W I 1 G W 1 2 W 1 W G G W G W W I G G W W I I W I G W W W 2 W 2 2 W W I G G
W 2 W 2 I G 2 W G W W G W W W G G W 1 I 1 G I I G I W G W G I 1 G W W W G I W G I I I G I W W W W 2 W G I G I I I W W W I I G 2 W W W I W W I W G 2 G G G I W W W W G G G G W G W W I W G W W 1 G G W I I I I G I 2 W W W
W G I W W W W W G W G G G 2 W W 2 W G I I G W I W W W I W W W G W I I G W W W I G G W 2 W I I W I I I G G W G G G G W W G I W G W W W W W I W 2 W W I I W W W W W W G W G W W W W W I W I W W W I G W 2 W W G W I W W W W
W W W I W G W W I G I W I G W G 2 W W G W W I W W I 1 W W I I G G W I W W W W W W I W G I G G G W G G W G G I W G W I 2 1 1 W W I W W W G I W I W G G G I G G W W I G G W W I 2 W G 1 G I W 2 G W I W W W W W I W I G I 2
G W G W G W G G G G I G G W W W W W W I I W I I G I G I G W I G I W W W W G I W W G I 2 1 G G I W 1 I W G 1 W G I W I G I I G I W W G W W W W W W W W W W W W G G I W G W G G W W W W I W W I W W G G I W W W I W G G I 2
I W I I G W I W I I W I G W I I W W W W I W I G I W W W I G I W W I G G G W W I I W G I I W G W W W W G W W I W W W I W I I G I W G G W W I G W W I W W W G G I W G W G W W W I W G G G G I W G I W G W W W G W W G W W W W
I G W W W W W W W W G I W I W W G I W G I G W G I W W I W W W W I G W W G W I I I I W I G W W W W W I W W I W W W I W I I W W W W G W I W W G W G W W W I I G G G W I W W W G W G W W W W G W W W W G G W W W W W W I W W W
G G G G G W G I W W I W W I W W W W W W I G W G W G G W W G G G W W W W G I W I G W G G W W W W W G W W W W W I W W W I W W G W W G G W W I G W W W I G I W G I I G W G W W G G I G G I W I I W W W W W W W I W W W W G G W
I G W W I W W W W W I W I W G W G W W I G W G G W G W W G I W I W W W W G W G G W W W G W W G G I G G W W W G W I G W W I I W I W I I W G G G G W I G W W W W W W I W G I W W G W W W W W W W W W I W I W G I I G G G W W W
W I G I I G W W G I G I W W W W W G W I I G W W W G I W W W W I G W I G I W W W W W W W W I W G G W W W W G W W I I W W W W W I I I W G G I I W G W G W W G I W W W W I W G W W G W W I W W W W G G I G G W G G W I W I W I
W I G W I W I W W W I G W W I I W W I G W W W I G G W W W W W I I I G W W G I G W W W W G I W W I W I W W W G W W I G W W G W W W G W I W W G I G I W G I W W W G G G I I I G G I W W W W W W W I W G G W G I W W W W W W W
G G G W W W W G I W W I I W W I W W G W W W I I G W W W G I W W W W G W W W W I G W G W W I I W I W I W W G G G I I W W G W G G W W W W W I W G I W I G G W I G W G W G W W W G W I I I W W W W W W W W I W W I W W I G W I
W G W W W W W I G W W W G W I G I G G I W W G G I W I W W W G W G G W I W W W W I W W W W W W I W W W W G G W G I W W W G W W W W W G I I G W W G W G W G G W W W W W W W I G W G W I I G I G W I I W W I G G G W G G I I W
W G G W W W I G I I G W I G W W G I I W W W W W G G W G W W I G W I W W W W W W I G W G W G I W W W W W I W G W W G W I W G G W W G W I I W W W G G G I I W I W G W W W I W G W G W W W I G W I I W W W W W W W G W G I W W
W W W W W W G I G G I W I G I W G W W W W W I I W G G W W W G I W W G W G W W I W W I G I W W G I W G G G W W W W I W W I I W I W W W W W W G W W W I W G W W W W W I W G I W W I I W W W W W W I G I I W W W W W I G W W W W
G I W W W W I I G W I W I G W W W W W I G I I I W W W W G G W W G W G W G I W W W W I W I W W W W W W W I G W I W I W W W G G W G W W W G W W G I W W I W W I W G I W G W W G G W W I W I G W W I G W I W W W W W I W W W W
I W G I G W I W I G I W G W W I W I I W W I I G W W W W W W W G I W G I W G W W W W W I W W W W G G W W G I G G W W W W W G G W G W I G W W G W I G W I W I I W W W W W I W W W W W W I G W I W W W I G W W W I W W W W W W
W W G W G W W G G G W W G I W W W G I W W W I W I W W I W W W G I W W W W W W G W W W W G W W W G G W W I W W W I G W W W W W W I I W W G G I I W I G W G I W W I W W W G W W W W W W W W W W W W G G G I I W W W W W W G W W
G W W G W W W I W I I G W W W W I I W W I W W W G W W W I G W W W W W W W W W W W W I I W W I W W W W W W G W G W W W W G I W W G W W I W W W W W I I W I G W W W I I I G I G W G G W W W I W G W W W W W W W W W G W W W I
G G W W W W W I G W W W W W I W G W I W W G W W I W W W W G I W W W G W W G W W W G W W W G W W W W I I I W W W W W W W I W W G I G G W W I W W G W G G G I W G W W W G G W W W W G W W G G W I W W G G W I W W W I G W I I
I W W I W I W W W I W G W I W W I W I I W G I G W W W W W W I G I W G I I W I W G W G G W G W W W G I G W W W W W G W W W W G W W W W W I W W I W I W W W W W W W W W G W W W W I W G I W W I G I W I W W G I W W G W W W W W
G I G W G W W G W W W I W W W I W W I W W I W I W G W G G W G I G I I W W W W I W W W W W W I G W I W I W W W W G W W W G W G W I I G G G G G W W I W W W W G G W W G I I G W G I G W W G W W W W W W W W W W W I G I G W I
G W W I G W I W W W W G G W W W I W G W W W W W I W W I W I W W W W W I W I G W I W G W W I W W G W I W W I W G W I I W W G W I W W W W W G W W I W I W W W W G G G W W I W G W W W W G I I G G W W W G W W W I W I W G G W
W W G I G I G W G W W I G W W W W W W I G W G W W W W G G G W W G W W I W G W W G W W W G W W W G W W G W W W G W W W W W W I W I W W W W W G G G W W W W W W W I I G I W W W G W W W W W G W W G W W G G W W W W W I I G W
W G W W G I W I W W W I W W W W I G W G W W W G W G W I W W I W W I W W W W W G I W W I I W W W W G I W W W W W W W W I W W W W W W G G G W W W I G W W W W I W G W I W G W W G G G W G W W G G I W W W I W W W I G W G W I
W W W I W W I W W W W G W W I I W G I W W W W W W W W W G W W W W I W W G W G W W W W W W W W I I I I W I G G W G W W W W W G W W W I G W G W W W G W W W W I W W W I G W W W W W I W W I W I W W W W G W W W W W W G W I G
W W W W W W G I W W I W W G W W W G G G I I W W W G W W G W W W W G W G W I W W W W G W W W W W W W I I G W W W G W W I W G W W G G W G W W W W G W W W W W W W W W W W W W W I W I G I W I W W W W G W W G W I W I G G W
G W W W I W I W W W W W W W I W W I W G W G G W W G W W W G G G I G W W W G W W W W W W W W W W W W I I I W G I W W W W W W W W W I W W G W W G W W W W W W W W W W W G W I G I W G I W W W W W W W W W G W W W W G W G W W
W G I I W W W W W W I I W I W I W W W W W W W W W W G W W W W W W W W G G G W G W W G W W G I G G W G W W W W W I I W G W W W W G W G W W W G W W W W W G I W W W W W W W W W W W W G G W W I W W I W W W W W W W I W I I W
W W G I W W G I G W G I G W W W W W W W W G W G G W I I W W G W W W W W W W W W W W W W W W W W G W W W W W I W W I W W W I G G W G W W W G W G I W I W I W W I W W I W G W W W I W I W W W W W I G I W W G G W I W W G W W

